################################################################################
#                                                                              #
#  ## ### ##  ### ##     ##  ###  ## ###  ##                     ### ##   #    #
# ### ##  ##  ##  ##     ###  ##  ##  ##  ##                     ### ### ###   #
# ###     #   #          ###       #   #                          #  ##  ###   #
#                                                                              #
# ###   #       #        ### #       #                            ##  #  ##    #
# ###  ##  ##  ##  ##    ### ##  ##  ##  ##                      ### ### ###   #
# ##   ## ### ###  ##     ## ##  ### ### ##                       ##  #   #    #
#                                                                              #
#  ##   #  ##  ###  #   ## ##   #   #   ## ##  ### ###            ##  #   #    #
#   #   #  ##   #   #   #   #   #   #   ## ##   ## ##            ### ### ###   #
#  ##   #  ##   #  ###  #   #  ##   ## ### ###  ## ##             #  ##   ##   #
#                                                                              #
# ###         #     #           # #   #     # ### ###                          #
# ### ### ### ### ### ### ### ### ### ### ### ### ###                          #
#         ### #     #   # #           ### ### #     #                          #
#                                                                              #
#                                                                              #
#                                                                              #
#                                                                              #
################################################################################
