################################################################################
#                                                                              #
#  #   #   #   #       #   #           #                                       #
# ### ### ##   ## ### ##   ## ##   ##  #   ###                                 #
#  #       #   #   #           #   #   #                                       #
#                                                                              #
#  #   #   #   #    #  ## ##  ### ###  #                                       #
# ### ### ##   ## ### ### ### ### ###  #   ##                                  #
#  ## #    ## ##   #  ### ###  ## ##                                           #
#                                                                              #
#  #   #   ## ##  #   ### ### #     #                                          #
# ### ### ##   ## ### ##   ## ##   ##  #    ##                                 #
# ##    #  #   #   #          ##   ##  #                                       #
#                                                                              #
#      #   ## ##  ### ##   ##                                                  #
#     ### ### ### ### ##   ## ##   ##                                          #
#     ###  ## ##   #  #     # ### ###                                          #
#                                                                       ##     #
#      #   ## ##  # # ### ### #     #                                   ## ### #
#     ### ##   ## ### ##   ## ##   ##                                   ## ### #
#     # #  ## ##   #  #     # ### ###                                          #
#####                                  #########################################
