################################################################################
#                                                                              #
#  ## ### ##  ### ##   ##  ###  ## ###  ##  ###   #       #                    #
# ### #   #   #   #    ###   #   #   #   #  # #   #   #   #   #                #
# ###     #   #        ###       #   #      ##   ## ### ###  ##                #
#                                                                              #
# ###   #       #      ### #       #       ### ##   #   ##  #  ##   ##  #   #  #
# # #   #   #   #   #  ### #   #   #   #   ### ### ### ### ### ### ### ### ### #
# ##   ## ### ###  ##   ## ##  ### ### ##   #  ##  ###  ##  #   #   #  ##   ## #
#                                                                              #
#  ##. .#. ##. ###  #   ## ##   #   #   ## ##  ### ###                         #
#   #. .#. ##.  #   #   #   #   #   #   ## ##   ## ##                          #
#  ##. .#. ##.  #  ### .#.  #. ##. .## ### ###  ## ##                          #
#                                                                              #
# ###         #     #           # #   #     # ### ###                          #
# ### ### ### ### ### ### ### ### ### ### ### ### ###                          #
#         ### #     #   # #           ### ### #     #                          #
#                                                                              #
#                                                                              #
#                                                                              #
#                                                                              #
################################################################################
